UNEXPECTEDLY|in a way that was not expected; "her brother showed up at the wedding out of the blue"  
DEFIANTLY|in a rebellious manner; "he rejected her words rebelliously"  
JOYFULLY|in a joyous and gleeful manner; "the old man had greeted her gleefully"  
DAZZLINGLY|in a manner or to a degree that dazzles the beholder  
ASAP|as soon as possible  
WORRYINGLY|in a manner to cause worry  
SUPER|to an extreme degree; "extremely cold"; "extremely unpleasant"  
WILD|in an uncontrolled and rampant manner; "weeds grew rampantly around here"  
UNCERTAINLY|in an unsteady manner; "he walked unsteadily toward the exit"; "The wounded soldier was swinging unsteadily on his legs"  
DECEIVINGLY|in a misleading way; "the exam looked deceptively easy"  
CONSCIENTIOUSLY|with extreme conscientiousness; "he came religiously every morning at 8 o'clock"  
CIRCULARLY|in a circular manner  
SOUTHWESTWARDLY|in a southwestward direction  
DESPONDENTLY|with desperation; "`Why can't you understand?,' she asked despairingly"  
JERKILY|with spasms; "the mouth was slightly open, and jerked violently and spasmodically at one corner"  
CRISSCROSS|crossing one another in opposite directions  
SATISFACTORILY|in a satisfactory manner  
RAMBLINGLY|in a rambling manner  
GODDAMNED|extremely; "you are goddamn right!"  
AFFABLY|in an affable manner; "`Come and visit me,' he said amiably"  
BEWILDEREDLY|in a bewildered manner  
PICKABACK|on a railroad flatcar; "the trailer rode piggyback across the country"  
CONTUMACIOUSLY|in a rebellious manner; "he rejected her words rebelliously"  
DETESTABLY|in an offensive and hateful manner; "I don't know anyone who could have behaved so abominably"  
TUNEFULLY|in a melodious manner; "she sang melodiously"  
NEEDFULLY|in an essential manner; "such expenses are necessarily incurred"  
EVENHANDEDLY|without favoring one party, in a fair evenhanded manner; "deal fairly with one another"  
THERAPEUTICALLY|for therapeutic purposes  
STANCHLY|in a staunch manner; "he staunchly defended his principles"  
INCONSEQUENTLY|lacking consequence; "`You're so beautifully dressed,' she said and added quite inconsequentially, `Can you stay the night?'"  
PERSPICUOUSLY|in a clear and lucid manner; "this is a lucidly written book"  
THERMALLY|by means of heat or with respect to thermal properties  
REMORSEFULLY|in a rueful manner; "`I made a big mistake,' he said ruefully"  
THEREINAFTER|in the following part of a given matter, as in a document or speech  
APTLY|with competence; in a competent capable manner; "they worked competently"  
UNCLEARLY|in a manner that is unclear  
PERCEPTIBLY|in a noticeable manner; "he changed noticeably over the years"  
INEXACTLY|in an imprecise manner; "he expressed himself imprecisely"  
ATROCIOUSLY|in a terrible manner; "she sings terribly"  
SKEPTICALLY|with scepticism; in a sceptical manner; "he looked at her sceptically"  
PIOUSLY|in a devout and pious manner; "she was devoutly Catholic"  
BENIGNANTLY|in a benign manner; "this drug is benignly soporific"  
MINDFULLY|in a careful deliberate manner  
ABSENTMINDEDLY|in an absentminded or preoccupied manner; "he read the letter absently"  
INCAUTIOUSLY|without caution or prudence; "one unfortunately sees historic features carelessly lost when estates fall into unsympathetic hands"  
MARTIALLY|in a martial manner  
COMMENDABLE|in an admirable manner; "the children's responses were admirably normal"  
PRIMARILY|for the most part; "he is mainly interested in butterflies"  
ECCENTRICALLY|in an eccentric or bizarre manner  
PROVABLY|in an obvious and provable manner; "his documentary sources are demonstrably wrong"  
HEREAFTER|in a subsequent part of this document or statement or matter etc.; "the landlord demises unto the tenant the premises hereinafter called the demised premises"; "the terms specified hereunder"  
POLYSYLLABICALLY|in a polysyllabic manner  
LARGO|slowly and broadly  
UNDERSTANDABLY|in an intelligible manner; "the foreigner spoke to us quite intelligibly"  
RETENTIVELY|in a retentive manner  
JOCOSELY|with humor; "they tried to deal with this painful subject jocularly"  
CONFORMABLY|in a conformable manner  
ABEAM|at right angles to the length of a ship or airplane  
UNDRAMATICALLY|in an undramatic manner  
REVERENTIALLY|with reverence; in a reverent manner; "he gazed reverently at the handiwork"  
LUSCIOUSLY|so as to produce a delightful taste; "I bought some more of these deliciously sweet peaches"  
LASCIVIOUSLY|in a lascivious manner  
OBNOXIOUSLY|in an obnoxious manner; "he said so in one of his more offensively intellectually arrogant sentences"  
PRESSINGLY|in a pressing manner  
FAVOURABLY|showing approval; "he reviewed the play favorably"  
ANTITHETICALLY|with antithesis; in an antithetical manner  
COMPOSEDLY|in a self-collected or self-possessed manner; "he announced the death of his father collectedly"  
SYNERGISTICALLY|(of group) in a synergistic or cooperative manner  
UNSPEAKABLY|to an inexpressible degree; "she was looking very young tonight, and, as usual, indescribably beautiful, in a simple strapless dress of a green and white silky cotton"  
TURGIDLY|in a turgid manner; "he lectured bombastically about his theories"  
TEMPTINGLY|in a tempting seductive manner; "she smiled at him seductively"  
MIDMOST|the middle or central part or point; "in the midst of the forest"; "could he walk out in the midst of his piece?"  
ALFRESCO|outside a building; "in summer we play outside"  
EVENTUALLY|after an unspecified period of time or an especially long delay  
SATISFYINGLY|in a gratifying manner; "the performance was at a gratifyingly high level"  
CONFESSEDLY|as acknowledged; "true, she is the smartest in her class"  
UNCOMPARABLY|in an incomparable manner or to an incomparable degree; "she is incomparably gifted"  
INFLUENTIALLY|exerting influence  
ABRUPTLY|quickly and without warning; "he stopped suddenly"  
INSOMUCH|to such an extent or degree; so  
UNOFFICIALLY|without official authorization; "he had made some money on the side"  
TRANSVERSALLY|in a transverse manner; "they were cut transversely"  
UNDEPENDABLY|in an unfaithful undependable unreliable manner  
UNADVISEDLY|in an unadvised manner  
PERMISSIBLY|in a permissible manner  
QUERULOUSLY|in a peevish manner  
PATCHILY|in spots  
DELIBERATELY|with intention; in an intentional manner; "he used that word intentionally"; "I did this by choice"  
SUBMISSIVELY|in a servile manner; "he always acts so deferentially around his supervisor"  
EXCRUCIATINGLY|in a very painful manner; "the progress was agonizingly slow"  
IMPETUOUSLY|in an impulsive or impetuous way; without taking cautions; "he often acts impulsively and later regrets it"  
SUPRA|at an earlier place; "see above"  
RECEPTIVELY|in a receptive manner  
ATTRACTIVELY|in a beautiful manner; "her face was beautifully made up"  
PEREMPTORILY|in an imperative and commanding manner  
INGLORIOUSLY|in a dishonorable manner or to a dishonorable degree; "his grades were disgracefully low"  
PIQUANTLY|with strong spices; in a spicy manner; "the soup was spicily flavored"  
WITHAL|despite anything to the contrary (usually following a concession); "although I'm a little afraid, however I'd like to try it"; "while we disliked each other, nevertheless we agreed"; "he was a stern yet fair master"; "granted that it is dangerous, all the same I still want to go"  
HEAVENWARDS|toward heaven; "he pointed heavenward"  
ANYWAYS|used to indicate that a statement explains or supports a previous statement; "Anyhow, he is dead now"; "I think they're asleep; anyhow, they're quiet"; "I don't know what happened to it; anyway, it's gone"; "anyway, there is another factor to consider"; "I don't know how it started; in any case, there was a brief scuffle"; "in any event, the government faced a serious protest"; "but at any rate he got a knighthood for it"  
SAGELY|in a wise manner; "she acted wisely when she invited her parents"  
B.C.E.|of the period before the Common Era; preferred by some writers who are not Christians; "in 200 BCE"  
REVOLTINGLY|in a disgusting manner or to a disgusting degree; "the beggar was disgustingly filthy"  
PITIABLY|in a manner arousing sympathy and compassion; "the sick child cried pathetically"  
SICKENINGLY|in a disgusting manner or to a disgusting degree; "the beggar was disgustingly filthy"  
INADVERTENTLY|without knowledge or intention; "he unwittingly deleted the references"  
SNEAKILY|in a surreptitious manner; "he was watching her surreptitiously as she waited in the hotel lobby"  
MYSTERIOUSLY|in a cryptic manner; "we will meet again," he said cryptically  
EFFICACIOUSLY|in an effective manner; "these are real problems that can be dealt with most effectively by rational discussion"  
RIPELY|with mature or developed appearance  
OFFSIDE|illegally in advance of the ball or puck  
NE'ER|not ever; at no time in the past or future; "I have never been to China"; "I shall never forget this day"; "had never seen a circus"; "never on Sunday"; "I will never marry you!"  
UNTHINKING|in a thoughtless manner; "he stared thoughtlessly at the picture"  
GREEDILY|in a greedy manner  
FRUITFULLY|in a productive way; "they worked together productively for two years"  
ABYSMALLY|in a terrible manner; "she sings terribly"  
BASHFULLY|in a shy or timid or bashful manner; "he smiled shyly"  
EROTICALLY|in an erotic manner  
NORTHWARD|in a northern direction; "they earn more up north"; "Let's go north!"  
HYPNOTICALLY|by means of hypnotism  
KNAVISHLY|in an artful manner; "he craftily arranged to be there when the decision was announced"; "had ever circumstances conspired so cunningly?"  
PRACTICABLY|in a practicable manner; so as to be feasible  
DEADLY|as if dead  
SUNNILY|in a cheerful manner; "`I'll do the dishes,' he said pleasantly"  
WHIMSICALLY|in a fanciful manner; "the Christmas tree was fancifully decorated"  
DEPARTMENTALLY|dependent on a department  
COMMONLY|under normal conditions; "usually she was late"  
EXTORTIONATELY|to an exorbitant degree; "prices are exorbitantly high in the capital"  
INEVITABLY|in such a manner as could not be otherwise; "it is necessarily so"; "we must needs by objective"  
FRANTICALLY|in an uncontrolled manner; "she fought back madly"  
DORSALLY|in a dorsal location or direction  
HITHER|to this place (especially toward the speaker); "come here, please"  
CORRUPTLY|in a corrupt manner  
CONSEQUENTIALLY|having consequence  
PLUNK|with a short hollow thud; "plop came the ball down to the corner of the green"  
VACUOUSLY|in a vacuous manner  
BRIGHTLY|with brightness; "the stars shone brilliantly"; "the windows glowed jewel bright"  
CORDIALLY|in a hearty manner; "`Yes,' the children chorused heartily"; "We welcomed her warmly"  
TAWDRILY|in a tastelessly garish manner; "the temple was garishly decorated with bright plastic flowers"  
DRAGGINGLY|in a dragging manner  
FOREVERMORE|at any future time; in the future; "lead a blameless life evermore"  
LAWFULLY|in a manner acceptable to common custom; "you cannot do this legitimately!"  
SCRAPPILY|in a bellicose contentious manner; "`Don't trespass onto my property,' the neighbor shouted combatively"  
MOMENTOUSLY|in a momentous way  
HAPHAZARDLY|in a random manner; "the houses were randomly scattered"; "bullets were fired into the crowd at random"  
ATHWART|at right angles to the center line of a ship  
O.K.|in a satisfactory or adequate manner; "she'll do okay on her own"; "held up all right under pressure"; (`alright' is a nonstandard variant of `all right')  
MODISHLY|in a stylish manner; "He was smartly dressed"  
PERSEVERINGLY|with perseverance  
AMOK|wildly; without self-control; "when the restaurant caught fire the patrons ran amuck, blocking the exit"  
TRANSITIONALLY|as a transitional step or in a transitional manner  
BAREBACKED|without a saddle; "she prefers to ride her horse bareback"  
DOWNRIGHT|thoroughgoing; "he is outright dishonest"  
SHEER|straight up or down without a break  
DISDAINFULLY|in a proud and domineering manner; "he treated his staff cavalierly"  
DAMN|extremely; "you are bloody right"; "Why are you so all-fired aggressive?"  
ODIOUSLY|in an offensive and hateful manner; "I don't know anyone who could have behaved so abominably"  
GRUBBILY|in a dingy manner  
CAUDALLY|toward the posterior end of the body  
DAMNED|in a damnable manner; "kindly Arthur--so damnably , politely , endlessly persistent!"  
FORTISSIMO|a direction in music; to be played very loudly  
INDIVIDUALISTICALLY|in an individualistic manner  
ENTREATINGLY|in a beseeching manner; "`You must help me,' she said imploringly"  
NIGHEST|(superlative of `near' or `close') within the shortest distance; "that was the time he came nearest to death"  
FASTER|more quickly  
UNSTINTINGLY|in an unstinting manner  
POUTINGLY|with a pout or in a pouting manner  
SIDESPLITTINGLY|in a very humorous manner  
TRANSITORILY|for a very brief time  
NORTHWARDS|in a northern direction; "they earn more up north"; "Let's go north!"  
USURIOUSLY|to an exorbitant degree; "prices are exorbitantly high in the capital"  
INCONTROVERTIBLY|in an obvious and provable manner; "his documentary sources are demonstrably wrong"  
TENACIOUSLY|with obstinate determination; "he pursued her doggedly"  
SELDOM|not often; "we rarely met"  
LIMITEDLY|in a limited manner  
KINDA|to some (great or small) extent; "it was rather cold"; "the party was rather nice"; "the knife is rather dull"; "I rather regret that I cannot attend"; "He's rather good at playing the cello"; "he is kind of shy"  
INVIDIOUSLY|in a manner arousing resentment  
SLANTINGLY|with a slant  
SORROWFULLY|in a sorrowful manner  
UNGRATEFULLY|in an ungrateful manner  
SLIGHTINGLY|in a disparaging manner; "these mythological figures are described disparagingly as belonging `only to a story'"  
SULTRILY|in a sultry and sensual manner; "the belly dancer mover sensually among the tables"  
UNIMAGINABLY|to an unimaginable extent  
MISTRUSTFULLY|with distrust; "she looked at him distrustfully"  
CONTEXTUALLY|in a manner dependent on context  
ANISOTROPICALLY|in an anisotropic manner  
WHEEZINGLY|with a wheeze; "he talked wheezily"  
PERIODICALLY|in a sporadic manner; "he only works sporadically"  
DUMBLY|in a stupid manner; "he had so rapaciously desired and so obtusely expected to find her alone"  
INEFFICACIOUSLY|in an ineffective manner; "he dealt with the problem rather ineffectively"  
UNTHINKABLY|to an unimaginable extent  
ORDINARILY|under normal conditions; "usually she was late"  
RASHLY|in a hasty and foolhardy manner; "he fell headlong in love with his cousin"  
OVERLY|to a degree exceeding normal or proper limits; "too big"  
IRREPROACHABLY|in an irreproachable and blameless manner; "she had lived blamelessly until she met this man"  
SCORNFULLY|without respect; in a disdainful manner; "she spoke of him contemptuously"  
PRURIENTLY|in a prurient manner  
SMOULDERINGLY|with barely repressed anger; "`I can't wait,' she answered smolderingly"  
ENTHRALLINGLY|in a bewitching manner; "she was bewitchingly beautiful"  
GRAVELY|in a grave and sober manner; "he walked soberly toward the altar"  
DOWNWARDS|spatially or metaphorically from a higher to a lower level or position; "don't fall down"; "rode the lift up and skied down"; "prices plunged downward"  
HAZARDOUSLY|in a dangerous manner; "he came dangerously close to falling off the ledge"  
BIWEEKLY|twice a week; "he called home semiweekly"  
FITTINGLY|in an appropriate manner; "he was appropriately dressed"  
EPISODICALLY|in an episodic manner  
CREDIBLY|easy to believe on the basis of available evidence; "he talked plausibly before the committee"; "he will probably win the election"  
PALATABLY|in a palatable way  
TORTUOUSLY|with twists and turns  
UNWAVERINGLY|with resolute determination; "we firmly believed it"; "you must stand firm"  
PURELY|restricted to something; "we talked strictly business"  
UNPARDONABLY|in an unpardonable manner or to an unpardonable degree; "he was inexcusably cruel to his wife"  
SNIDELY|with a sneer; in an uncomplimentary sneering manner; "`I don't believe in these customs,' he said sneeringly"  
UNFAILINGLY|without fail  
EARLIEST|with the least delay; "the soonest I can arrive is 3 P.M."  
LANDWARDS|toward land; "landward, miles of rough grass marshes melt into low uplands"  
INELUCTABLY|by necessity; "the situation slid inescapably toward disaster "  
CRISPLY|in a well delineated manner; "the new style of Minoan pottery was sharply defined"  
UNALTERABLY|in an unalterable and unchangeable manner; "his views were unchangeably fixed"  
PROSPEROUSLY|in the manner of prosperous people  
EXTEMPORARILY|without prior preparation; "he spoke extemporaneously"  
CHIEFLY|for the most part; "he is mainly interested in butterflies"  
FOXILY|in an artful manner; "he craftily arranged to be there when the decision was announced"; "had ever circumstances conspired so cunningly?"  
IMPOSINGLY|in an impressive manner; "the students progressed impressively fast"  
ILLICITLY|in a manner disapproved or not allowed by custom; "He acted illegitimately when he increased the rent fourfold"  
DEFINITELY|without question and beyond doubt; "it was decidedly too expensive"; "she told him off in spades"; "by all odds they should win"  
HOMEWARDS|toward home; "fought his way homeward through the deep snow"  
HEBDOMADALLY|without missing a week; "she visited her aunt weekly"  
SALACIOUSLY|in a lascivious manner  
LAXLY|in a permissively lenient manner; "he felt incensed that Tarrant should have been treated so leniently given his crime"  
BEFITTINGLY|in an appropriate manner; "he was appropriately dressed"  
CONTEMPTIBLY|in a manner deserving contempt  
SURLILY|in a churlish manner; "the store owner treated his customers churlishly"  
COLLECTIVELY|in conjunction with; combined; "our salaries put together couldn't pay for the damage"; "we couldn't pay for the damages with all our salaries put together"  
RAFFISHLY|in a rakish manner; "she wore her hat rakishly at an angle"  
UPPISHLY|in a snobbish manner; "they snobbishly excluded their less wealthy friends from the party"  
PUNITIVELY|in a punishing manner  
ASHAMEDLY|with a feeling of shame  
MOONILY|in a dreamy manner; "`She would look beautiful in the new dress,' Tommy said dreamily"  
DOWNSTREAM|away from the source or with the current  
RAPACIOUSLY|in a rapacious manner  
BELIEVINGLY|in a credulous manner; "the children followed the teacher credulously"  
PRESUMPTIVELY|by reasonable assumption; "presumably, he missed the train"  
REPULSIVELY|in an offensive and hateful manner; "I don't know anyone who could have behaved so abominably"  
UPWIND|toward the wind; "they were sailing leeward"  
GLUMLY|in a sullen manner; "he sat in his chair dourly"  
ALRIGHT|without doubt (used to reinforce an assertion); "it's expensive all right"  
UNLUCKILY|by bad luck; "unfortunately it rained all day"; "alas, I cannot stay"  
AFFECTINGLY|in a poignant or touching manner; "she spoke poignantly"  
PRIMITIVELY|with reference to the origin or beginning  
WOLFISHLY|in the manner of a wolf  
SEAWARDS|in the direction of the sea; "the sailor looked seaward"  
HINDERINGLY|in an obstructive manner; "he acted very obstructively when we tried to carry out our project"  
HORRIBLY|of a dreadful kind; "there was a dreadfully bloody accident on the road this morning"  
INTEMPERATELY|indulging excessively; "he drank heavily"  
ACCEPTABLY|in an acceptable (but not outstanding) manner; "she plays tennis tolerably"  
UNBECOMINGLY|without decorousness  
INDISTINCTLY|in a dim indistinct manner; "we perceived the change only dimly"  
INTRADERMALLY|into the skin  
GENERALLY|usually; as a rule; "by and large it doesn't rain much here"  
SCOFFINGLY|in a disrespectful and mocking manner; "`Sorry,' she repeated derisively"  
SACREDLY|by religion; "religiously inspired art"  
VIGILANTLY|in a watchful manner  
EASTWARDS|toward the east; "they migrated eastward to Sweden"  
PUNITORILY|in a punishing manner  
RESOURCEFULLY|in a resourceful manner  
DISRUPTIVELY|in a disruptive manner  
MIRTHFULLY|in a joyous manner; "they shouted happily"  
GRATEFULLY|with appreciation; in a grateful manner; "he accepted my offer appreciatively"  
RESPLENDENTLY|in an impressively beautiful manner; "the Princess was gorgeously dressed"  
INDISCRIMINATELY|in a random manner; "the houses were randomly scattered"; "bullets were fired into the crowd at random"  
DEFTLY|with dexterity; in a dexterous manner; "dextrously he untied the knots"  
EXQUISITELY|in a delicate manner; "finely shaped features"; "her fine drawn body"  
PATRILINEALLY|by descent through the male line  
COURAGEOUSLY|in a courageous manner; "bravely he went into the burning house"  
SPORTIVELY|in a merry sportive manner  
UNQUALIFIEDLY|without qualification or limitation  
UNNOTICEABLY|in an imperceptible manner or to an imperceptible degree; "the power of the Secretary of State in London increased gradually but imperceptibly"  
CONTUMELIOUSLY|without respect; in a disdainful manner; "she spoke of him contemptuously"  
PATHOGENICALLY|in a pathogenic manner  
EMPATHETICALLY|in a sympathetic manner; "she listened to him sympathetically"  
UNHARMONIOUSLY|in a discordant manner; "the piece ended discordantly"  
DEPRESSINGLY|in a depressing manner or to a depressing degree  
C.E.|of the period coinciding with the Christian era; preferred by some writers who are not Christians; "in 200 CE"  
BUXOMLY|in a curvaceous way; "his date was curvaceously beguiling"  
REGIMENTALLY|in a regimental manner or by regiments  
DISSOLUTELY|in a dissolute way  
JURISPRUDENTIALLY|in respect to jurisprudence or the science or philosophy of law  
KNOWINGLY|with full knowledge and deliberation; "he wittingly deleted the references"  
PRECIOUSLY|extremely; "there is precious little time left"  
BAREFOOTED|without shoes on; "he chased her barefoot across the meadow"  
SILENTLY|without speaking; "he sat mutely next to her"  
UNDESIRABLY|in an undesirable manner; "he was unwantedly friendly"  
PROBLEMATICALLY|in such a way as to pose a problem  
PERTLY|in an impudent or impertinent manner; "a lean, swarthy fellow was peering through the window, grinning impudently"  
UNBELIEVABLY|not easy to believe; "behind you the coastal hills plunge to the incredibly blue sea backed by the Turkish mountains"  
LONGWAYS|in the direction of the length; "He cut the paper lengthwise"  
CYTOPHOTOMETRICALLY|by cytophotometric means  
KINAESTHETICALLY|in a kinesthetic manner; by means of kinesthesia; "he can perceive shapes kinesthetically"  
SLIMLY|in a slim or slender manner; "a slenderly built woman"; "slightly built"  
UNPROPITIOUSLY|in an inauspicious manner; "he started his new job inauspiciously on Friday the 13th"  
EXASPERATINGLY|in an exasperating manner  
PERILOUSLY|in a dangerous manner; "he came dangerously close to falling off the ledge"  
AGREEABLY|in an enjoyable manner; "we spent a pleasantly lazy afternoon"  
PROFLIGATELY|in a dissolute way  
REARWARDS|at or to or toward the back or rear; "he moved back"; "tripped when he stepped backward"; "she looked rearward out the window of the car"  
ERRONEOUSLY|in a mistaken manner; "he mistakenly believed it"  
HEEDFULLY|in a careful deliberate manner  
CRYPTOGRAPHICALLY|in a cryptographic manner  
PARDONABLY|in an excusable manner or to an excusable degree; "he was excusably late"  
TOUCHINGLY|in a poignant or touching manner; "she spoke poignantly"  
GEOTHERMALLY|by means of heat from the interior of the earth  
ORNAMENTALLY|in an ornamental, nonfunctional manner  
INTRACTABLY|in an intractable manner  
WAGGISHLY|in a waggish manner  
GRAYLY|having a grey appearance; "lonely creeks are opal in the dawn, sword-blue in the sun, greyly silver under misty moons"  
MENDACIOUSLY|in a mendacious and untruthful manner; "I told him, quite untruthfully, that I had just returned from leave"  
O'ER|throughout a period of time; "stay over the weekend"  
DEMONIACALLY|in a very agitated manner; as if possessed by an evil spirit  
UNFAVOURABLY|showing disapproval; in a disparaging way; "he reviewed the play unfavorably"  
WHENCE|from what place, source, or cause  
GROUCHILY|in an ill-natured manner; "she looked at her husband crossly"  
TYPOGRAPHICALLY|in a typographic way  
FASTEST|most quickly  
CUSTOMARILY|by custom; according to common practice; "children are custosby-the-waymarily expected to be seen but not heard"  
ABAXIALLY|in an abaxial manner  
FORGIVABLY|in an excusable manner or to an excusable degree; "he was excusably late"  
CAJOLINGLY|in a cajoling manner; "`Come here,' she said coaxingly"  
UPROARIOUSLY|in a hilarious manner; "hilariously funny"  
BITINGLY|extremely and sharply; "it was bitterly cold"; "bitter cold"  
LONGWISE|in the direction of the length; "He cut the paper lengthwise"  
ETC.|continuing in the same way  
CROOKEDLY|in a crooked lopsided manner; "he smiled lopsidedly"  
VAUNTINGLY|in a boastful manner; "he talked big all evening"  
UNMANFULLY|without qualities thought to befit a man  
LOVINGLY|with fondness; with love; "she spoke to her children fondly"  
NERVELESSLY|in a composed and unconcerned manner; "without more ado Barker borrowed a knife from his brigade Major and honed it on a carborundum stone as coolly as a butcher"  
FERVIDLY|with passionate fervor; "both those for and against are fervently convinced they speak for the great majority of the people"; "a fierily opinionated book"  
CAPABLY|with competence; in a competent capable manner; "they worked competently"  
PHILANTHROPICALLY|in a philanthropic manner  
MEASUREDLY|in a deliberate unhurried manner; "she was working deliberately"  
EXPEDIENTLY|in an expedient manner  
DISCOURTEOUSLY|in an impolite manner; "he treated her impolitely"  
SINUSOIDALLY|in a sinusoidal manner  
E.G.|as an example; "take ribbon snakes, for example"  
PUNISHINGLY|in a punishing manner  
FORSOOTH|an archaic word originally meaning `in truth' but now usually used to express disbelief  
GAUDILY|in a tastelessly garish manner; "the temple was garishly decorated with bright plastic flowers"  
SEDATELY|in a sedate manner  
CEREMONIALLY|in a ceremonious manner; "my mother advised her children ceremoniously"  
WHERESOEVER|where in the world  
INVITINGLY|in a tantalizing manner; "she smiled at him tantalizingly"  
PASSING|to an extreme degree; "extremely cold"; "extremely unpleasant"  
CONNUBIAL|in a conjugal manner  
PROFITLESSLY|without gain or profit  
MARVELOUSLY|(used as an intensifier) extremely well; "her voice is superbly disciplined"; "the colors changed wondrously slowly"  
FUNDAMENTALLY|in essence; at bottom or by one's (or its) very nature; "He is basically dishonest"; "the argument was essentially a technical one"; "for all his bluster he is in essence a shy person"  
ENIGMATICALLY|in a cryptic manner; "we will meet again," he said cryptically  
MISLEADINGLY|in a misleading way; "the exam looked deceptively easy"  
HENCEFORWARD|from this time forth; from now on; "henceforth she will be known as Mrs. Smith"  
MANAGERIALLY|in a managerial manner  
STRANGELY|in a strange manner; "a queerly inscribed sheet of paper"  
PITILESSLY|without pity; in a merciless manner; "he was mercilessly trounced by his opponent in the House"  
NORTHEASTWARDLY|in a northeastward direction; "the river flows northeastward to the gulf"  
SOMEWAYS|in some unspecified way or manner; or by some unspecified means; "they managed somehow"; "he expected somehow to discover a woman who would love him"; "he tried to make is someway acceptable"  
TOMORROW|the next day, the day after, following the present day  
FITLY|in an appropriate manner; "he was appropriately dressed"  
OBSESSIONALLY|in a compulsive manner; "he cleaned his shoes compulsively after every walk"  
SYMPTOMATICALLY|by symptoms  
LIKELY|with considerable certainty; without much doubt; "He is probably out of the country"; "in all likelihood we are headed for war"  
AGGRESSIVELY|in an aggressive manner; "she was being sharply questioned"  
FORRADER|in a forward direction; "go ahead"; "the train moved ahead slowly"; "the boat lurched ahead"; "moved onward into the forest"; "they went slowly forward in the mud"  
SARDONICALLY|in a sarcastic manner; "`Ah, now we're getting at the truth,' he interposed sarcastically"  
KILLINGLY|in a very humorous manner  
FULSOMELY|in an unctuous manner  
REPREHENSIBLY|in a manner or to a degree deserving blame or censure  
RAPIDLY|with rapid movements; "he works quickly"  
CONFIDINGLY|with trust; in a trusting manner; "she looked at her father trustingly"  
PARENTALLY|in a parental manner  
EXAGGERATEDLY|in an exaggerated manner  
UNRESTRAINEDLY|in an unrestrained manner  
COMPLEXLY|in a complex manner  
COSILY|in a cozy manner; "nestled cozily by the fire"  
DISPUTATIOUSLY|in a disputatious manner  
UNFORGIVABLY|in an unpardonable manner or to an unpardonable degree; "he was inexcusably cruel to his wife"  
UNWONTEDLY|in an unusual manner  
NUTTILY|in a mildly insane manner; "the old lady is beginning to behave quite dottily"  
REMORSELESSLY|without pity; in a merciless manner; "he was mercilessly trounced by his opponent in the House"  
AWFULLY|used as intensifiers; "terribly interesting"; "I'm awful sorry"  
MONSTROUSLY|in a hideous manner; "her face was hideously disfigured after the accident"  
ELEMENTARILY|in an elementary manner  
SPACEWARD|towards outer space  
ROTTENLY|in a terrible manner; "she sings terribly"  
RECURRENTLY|in a recurrent manner  
COURSE|as might be expected; "naturally, the lawyer sent us a huge bill"  
DICHOTOMOUSLY|in a dichotomous manner  
NOTWITHSTANDING|despite anything to the contrary (usually following a concession); "although I'm a little afraid, however I'd like to try it"; "while we disliked each other, nevertheless we agreed"; "he was a stern yet fair master"; "granted that it is dangerous, all the same I still want to go"  
MEDICINALLY|in a medicinal manner  
ERGO|(used as a sentence connector) therefore or consequently  
AFFIRMATIVELY|in an affirmative manner  
UNEASILY|with anxiety or apprehension; "we watched anxiously"  
FANTASTICALLY|exceedingly; extremely; "she plays fabulously well"  
DREARILY|in a cheerless manner; "in August 1914 , there was a dismally sentimental little dinner, when the French, German, Austrian and Belgian members of the committee drank together to the peace of the future"  
GREGARIOUSLY|in a gregarious manner  
CONTROVERSIALLY|involving controversy; "criticism too polemically stated"  
RELUCTANTLY|with reluctance  
BALMILY|in a mildly insane manner; "the old lady is beginning to behave quite dottily"  
UNPRODUCTIVELY|in an unproductive manner  
OPULENTLY|in a sumptuous and opulent manner; "this government building is sumptuously appointed"  
COURTEOUSLY|in a polite manner; "the policeman answered politely, `Now look here, lady...'"  
REPROACHFULLY|in a reproving or reproachful manner; "she spoke to him reprovingly"  
GRAPHICALLY|in a diagrammatic manner; "the landscape unit drawn diagrammatically illustrates the gentle rolling relief, with a peat-filled basin"  
STAGILY|in a stagy and theatrical manner; "`I cannot show my face at her house,' he declared theatrically"  
SAPIENTLY|in a shrewd manner; "he invested his fortune astutely"; "he was acutely insightful"  
CROSSWAYS|transversely; "the marble slabs were cut across"  
SHAMELESSLY|without shame; "he unashamedly abandoned the project when he realized he would not gain from it"  
TOPPINGLY|(used as an intensifier) extremely well; "her voice is superbly disciplined"; "the colors changed wondrously slowly"  
SELFISHLY|in an egotistical manner; "he behaved egotistically"  
SCHISMATICALLY|in a manner that is schismatic  
PREPONDERANTLY|much greater in number or influence; "the patients are predominantly indigenous"  
IMPORTUNATELY|in a beseeching manner; "`You must help me,' she said imploringly"  
VIDELICET|as follows  
PLAGUY|in a disagreeable manner; "it's so plaguey cold!"  
THENCEFORTH|from that time on; "thereafter he never called again"  
MALIGNLY|in a malign and evil manner  
DISREGARDLESS|in spite of everything; without regard to drawbacks; "he carried on regardless of the difficulties"  
BELIKE|with considerable certainty; without much doubt; "He is probably out of the country"; "in all likelihood we are headed for war"  
WORTHLESSLY|in a worthless manner  
YEAH|not only so, but; "I therein do rejoice, yea, and will rejoice"  
CARNALLY|in a carnal manner  
MANGILY|in a mangy manner  
EDGEWAYS|as if by an edge; barely; "I could not get a word in edgewise"  
UNCOMPROMISINGLY|in an uncompromising manner  
FUGALLY|in a fugal style  
SNOOTILY|in a snobbish manner; "they snobbishly excluded their less wealthy friends from the party"  
BASELY|in a despicable, ignoble manner; "this new leader meanly threatens the deepest values of our society"  
INTERROGATIVELY|in a questioning format  
STRAIGHT|without deviation; "the path leads directly to the lake"; "went direct to the office"  
TALKILY|in a chatty loquacious manner; "`When I was young,' she continued loquaciously, `I used to do all sorts of naughty things'"  
ZESTILY|with zest; "she scrubbed the floors of the new apartment zestfully"  
SPACEWARDS|towards outer space  
RITUALLY|in a ceremonial manner; "he was ceremonially sworn in as President"  
INFORMATIVELY|in an informative manner  
ABSTRACTEDLY|in an absentminded or preoccupied manner; "he read the letter absently"  
BAREFACEDLY|without shame; "he unashamedly abandoned the project when he realized he would not gain from it"  
SCREAKILY|in a creaky manner; "the old boat was moving along creakily"  
UNSPARINGLY|in a scathing and unsparing manner; "she criticized him scathingly"  
FLAWLESSLY|in an adroit manner; "he bounced it cleanly off the wall"  
REPELLINGLY|in a repellent manner; "repellently fat"  
JEJUNELY|in an immature manner; "his teenage son still behaves very immaturely"  
UNRELIABLY|in an unfaithful undependable unreliable manner  
UNSYMMETRICALLY|in an asymmetrical manner; "they were asymmetrically arranged"  
SOTTISHLY|in a sottish manner  
E'EN|even  
HECTICALLY|in a frenzied manner; "we rehearsed frenziedly the last few days before the premiere"  
MEANLY|in a nasty ill-tempered manner; "`Don't expect me to help you,' he added nastily"  
ARCHLY|in_an_arch_manner; with playful slyness or roguishness  
POISONOUSLY|in a very malevolent manner  
FRIGIDLY|without warmth or enthusiasm; "`Come in if you have to,' he said frostily"  
THREATENINGLY|in a menacing manner; "the voice at the other end of the line dropped menacingly"  
DOLTISHLY|in a stupid manner; "he had stupidly bought a one way ticket"  
REPENTANTLY|showing remorse  
HUSKILY|in a hoarse or husky voice; "`Excuse me,' he said hoarsely"  
PRAISEWORTHILY|in an admirable manner; "the children's responses were admirably normal"  
NEBULOUSLY|in a nebulous and indefinite manner  
RURALLY|in a rural manner  
BREADTHWAYS|in the direction of the breadth; "cut the cloth breadthwise"  
VENGEFULLY|in a vindictive, revengeful manner; "he plotted vindictively against his former superiors"  
SIDEWARDS|toward one side; "turn the figure sideward"  
BAWDILY|in a bawdy manner  
INSENSATELY|in an insensate manner  
UNTHINKINGLY|in a thoughtless manner; "he stared thoughtlessly at the picture"  
VISCERALLY|in an unreasoning visceral manner  
UNFALTERINGLY|with determination; in a determined manner; "he clung to the past determinedly"  
SUPERNATURALLY|in a supernatural manner; "she was preternaturally beautiful"  
COINCIDENTALLY|happening at the same time  
PRESIDENTIALLY|in a presidential manner  
SHOWILY|with ostentation; in an ostentatious manner; "Mr Khrushchev ostentatiously wooed and embraced Castro at the U.N. general assembly"  
ABORAD|away from the mouth or oral region  
UNINSTRUCTIVELY|in an uninformative manner; "`I can't tell you when the manager will arrive,' he said rather uninformatively"  
MUNIFICENTLY|in a generous manner; "he gave liberally to several charities"  
PREPOSITIONALLY|as a preposition  
INVETERATE|in a habitual and longstanding manner; "smoking chronically"  
DECEITFULLY|in a corrupt and deceitful manner; "he acted dishonestly when he gave the contract to his best friend"  
DERISORILY|in a disrespectful and mocking manner; "`Sorry,' she repeated derisively"  
DEMEANINGLY|in a humiliating manner; "the painting was reproduced humiliatingly small"  
UNTIMELY|too soon; in a premature manner; "I spoke prematurely"  
CATEGORICALLY|in an unqualified manner; "he flatly denied the charges"  
ALSO|in addition; "he has a Mercedes, too"  
ENDOGENOUSLY|in an endogenous manner  
ABOARD|on a ship, train, plane or other vehicle  
IBID.|in the same place (used when citing a reference)  
UNWISELY|without good sense or judgment; "He acted foolishly when he agreed to come"  
MONOSYLLABICALLY|in a monosyllabic manner  
STRAGGLINGLY|in a ragged irregular manner; "a stone wall trails raggedly through the woods"  
STAGGERINGLY|extremely; "he was enormously popular"  
UNENDINGLY|with unflagging resolve; "dance inspires him ceaselessly to strive higher and higher toward the shining pinnacle of perfection that is the goal of every artiste"  
FRONTALLY|in, at, or toward the front  
LEGALLY|by law; conforming to the law; "we are lawfully wedded now"  
GROPINGLY|in an uncertain groping manner  
DETRIMENTALLY|in a detrimental manner  
ASEA|in the direction of the sea; "the sailor looked seaward"  
OUTWARDS|toward the outside; "move the needle further outward!"  
PLENTIFULLY|in a bountiful manner  
MOISTLY|in a damp manner; "a scarf was tied round her head but the rebellious curl had escaped and hung damply over her left eye"  
GRACELESSLY|without grace; rigidly; "they moved woodenly"  
TREASONABLY|in a disloyal and faithless manner; "he behaved treacherously"; "his wife played him false"  
NEGLECTFULLY|in a neglectful manner  
UNSPORTINGLY|in an unsportsmanlike manner  
OBDURATELY|in a stubborn unregenerate manner; "she remained stubbornly in the same position"  
FUTILELY|in a futile and unproductive manner  
COMPATIBLY|with compatibility  
ORAD|toward the mouth or oral region  
DOLCE|gently and sweetly  
TRAITOROUSLY|in a disloyal and faithless manner; "he behaved treacherously"; "his wife played him false"  
HITHERTO|used in negative statement to describe a situation that has existed up to this point or up to the present time; "So far he hasn't called"; "the sun isn't up yet"  
MULISHLY|in a stubborn unregenerate manner; "she remained stubbornly in the same position"  
CHARILY|with great caution; warily  
LUDICROUSLY|so as to arouse or deserve laughter; "her income was laughably small, but she managed to live well"  
UNAVOIDABLY|by necessity; "the situation slid inescapably toward disaster "  
IMMUNOLOGICALLY|from the point of view of immunology  
SMASHINGLY|with a loud crash; "the car went smash through the fence"  
JUBILANTLY|in a joyous manner; "they shouted happily"  
UNFORGETTABLY|in a memorable manner; "Horowitz could play Chopin memorably"  
INSTANTLY|without delay or hesitation; with no time intervening; "he answered immediately"; "found an answer straightaway"; "an official accused of dishonesty should be suspended forthwith"; "Come here now!"  
TERRIFICALLY|(used as an intensifier) extremely well; "her voice is superbly disciplined"; "the colors changed wondrously slowly"  
UNSATIABLY|to an insatiable degree; "she was insatiably hungry"  
MUSICOLOGICALLY|with respect to musicology  
COMPARATIVELY|in a relative manner; by comparison to something else; "the situation is relatively calm now"  
EVERLASTINGLY|for a limitless time; "no one can live forever"; "brightly beams our Father's mercy from his lighthouse evermore"- P.P.Bliss  
ONEROUSLY|in an onerous manner  
PERNICIOUSLY|in a harmfully insidious manner; "these drugs act insidiously"  
BOYLIKE|like a boy; "he smiled boyishly at his fiancee"  
SEPARATELY|apart from others; "taken individually, the rooms were, in fact, square"; "the fine points are treated singly"  
MAGNIFICENTLY|extremely well; "he did splendidly in the exam"; "we got along famously"  
PIERCINGLY|extremely and sharply; "it was bitterly cold"; "bitter cold"  
UPSTREAM|toward the source or against the current  
UNINTERESTINGLY|in an uninteresting manner  
CUSSEDLY|in a stubborn unregenerate manner; "she remained stubbornly in the same position"  
VENALLY|in a corrupt and deceitful manner; "he acted dishonestly when he gave the contract to his best friend"  
TRICKILY|in an artful manner; "he craftily arranged to be there when the decision was announced"; "had ever circumstances conspired so cunningly?"  
AVARICIOUSLY|in a greedy manner  
MULTIFARIOUSLY|in diverse ways; "the alternatives that are variously represented by the participants"; "the speakers treated the subject most diversely"  
SAUCILY|in an impudent or impertinent manner; "a lean, swarthy fellow was peering through the window, grinning impudently"  
GIDDILY|in a giddy light-headed manner; "he walked around dizzily"  
INELEGANTLY|without elegance  
TALKATIVELY|in a chatty loquacious manner; "`When I was young,' she continued loquaciously, `I used to do all sorts of naughty things'"  
UNRELENTINGLY|in a relentless manner; "he worked relentlessly"  
DISTRESSINGLY|unpleasantly; "his ignorance was painfully obvious"  
LAMENTABLY|in an unfortunate or deplorable manner; "he was sadly neglected"; "it was woefully inadequate"  
CLOYINGLY|in an overly sweet manner  
LENGTHWAYS|in the direction of the length; "He cut the paper lengthwise"  
BLUFFLY|in a blunt direct manner; "he spoke bluntly"; "he stated his opinion flat-out"; "he was criticized roundly"  
RELIABLY|in a faithful manner; "it always came on, faithfully, like the radio"  
UNAMBIGUOUSLY|in an unambiguous manner; "she stated her intentions unequivocally"  
PORNOGRAPHICALLY|in a pornographic manner  
INSCRUTABLY|in an inscrutable manner  
FRIGHTFULLY|used as intensifiers; "terribly interesting"; "I'm awful sorry"  
ALONGSIDE|side by side; "anchored close aboard another ship"  
PURITANICALLY|in a prudish manner; "she acts prudishly, but I wonder whether she is really all that chaste"  
TIRELESSLY|with indefatigable energy; "she watched the show indefatigably"  
DEVILISHLY|as a devil; in an evil manner; "his writing could be diabolically satiric"  
HEADFIRST|with the head foremost; "the runner slid headlong into third base"  
FLIRTATIOUSLY|in a flirtatious manner; "she smiled coquettishly"  
SUITABLY|in an appropriate manner; "he was appropriately dressed"  
LIMPIDLY|in a clear and lucid manner; "this is a lucidly written book"  
ENVIOUSLY|with jealousy; in an envious manner; "he looked at his friend's new car jealously"  
ABORTIVELY|in an unfruitful manner  
PUNILY|in a puny manner  
OBJECTIONABLY|in an obnoxious manner; "he said so in one of his more offensively intellectually arrogant sentences"  
UNGRACIOUSLY|without grace; rigidly; "they moved woodenly"  
POWERLESSLY|in a powerless manner  
PETTILY|in a petty way  
BIMONTHLY|twice a month; "salaries are paid semimonthly"  
SOUTHWARDS|toward the south; "the ship turned southerly"  
DISCREDITABLY|in a dishonorable manner or to a dishonorable degree; "his grades were disgracefully low"  
CUTELY|in an attractive manner; "how cunningly the olive-green dress with its underskirt of rose-brocade fitted her perfect figure"  
INDIGENOUSLY|in an indigenous manner  
UNPRECEDENTEDLY|in an unprecedented manner  
DOUBTLESSLY|without doubt; certainly; "it's undoubtedly very beautiful"  
CONSOLINGLY|in a comforting or consoling manner; "one part of a strange world should be given a comfortingly familiar form"  
ADVERTENTLY|in a careful deliberate manner  
IBIDEM|in the same place (used when citing a reference)  
ACCOMMODATINGLY|in accommodation; "obligingly, he lowered his voice"  
STEAMING|(used of heat) extremely; "the casserole was piping hot"  
INANELY|vacuously or complacently and unconsciously foolish  
IMPROMPTU|without advance preparation; "he spoke ad lib"  
RIDICULOUSLY|so as to arouse or deserve laughter; "her income was laughably small, but she managed to live well"  
PIANO|used as a direction in music; to be played relatively softly  
P.A.|by the year; every year (usually with reference to a sum of money paid or received); "he earned $100,000 per annum"; "we issue six volumes per annum"  
RAVINGLY|in a raving manner; "raving mad"  
ROOMILY|with ample room; "the furniture was spaciously spread out"  
IMPLAUSIBLY|not easy to believe; "behind you the coastal hills plunge to the incredibly blue sea backed by the Turkish mountains"  
VITRIOLICALLY|in a caustic vitriolic manner; "he addressed her caustically"  
ROTUNDLY|in a sonorous manner; "the congregation consisted chiefly of a few young folk, who snored sonorously"  
NIGHER|(comparative of `near' or `close') within a shorter distance; "come closer, my dear!"; "they drew nearer"; "getting nearer to the true explanation"  
TREPIDLY|in a timorous and trepid manner  
MATRILINEALLY|by descent through the female line  
HUGELY|extremely; "he was enormously popular"  
PEDAGOGICALLY|in a didactic manner; "this is a didactically sound method"  
CONJUGALLY|in a conjugal manner  
MIDWEEK|in the middle of the week  
WORTHILY|in a worthy manner; with worthiness  
DOCTRINALLY|as a matter of doctrine  
OFTENTIMES|many times at short intervals; "we often met over a cup of coffee"  
CONSISTENTLY|in a systematic or consistent manner; "they systematically excluded women"  
ETCETERA|continuing in the same way  
WACKILY|in a mildly insane manner; "the old lady is beginning to behave quite dottily"  
SPECIOUSLY|in a specious manner  
LOTS|to a very great degree or extent; "I feel a lot better"; "we enjoyed ourselves very much"; "she was very much interested"; "this would help a great deal"  
TIMIDLY|in a shy or timid or bashful manner; "he smiled shyly"  
NORTHERLY|in a northern direction; "they earn more up north"; "Let's go north!"  
UNIMAGINATIVELY|in a matter-of-fact manner; "I applied my attention prosaically to my routine"  
LACONICALLY|in a dry laconic manner; "I know that," he said dryly  
AFFECTEDLY|in an affected manner  
LICENTIOUSLY|in a licentious and promiscuous manner; "this young girl has to share a room with her mother who lives promiscuously"  
UNCEASINGLY|with unflagging resolve; "dance inspires him ceaselessly to strive higher and higher toward the shining pinnacle of perfection that is the goal of every artiste"  
FORMERLY|at a previous time; "at one time he loved her"; "her erstwhile writing"; "she was a dancer once";  
CONTRARILY|in a contrary disobedient manner  
GRUMPILY|in an ill-natured manner; "she looked at her husband crossly"  
CYTOPLASMICALLY|by means of cytoplasm  
DOUBTLESS|without doubt; certainly; "it's undoubtedly very beautiful"  
MULTILATERALLY|in a multilateral manner;so as to affect many parties or governments; "they worked out an agreement unilaterally"  
INFECTIOUSLY|in a contagious manner; "she was contagiously bubbly"  
JUDICIALLY|as ordered by a court  
SLYLY|in an artful manner; "he craftily arranged to be there when the decision was announced"; "had ever circumstances conspired so cunningly?"  
ALTRUISTICALLY|in an altruistic manner; "he acted selflessly when he helped the old lady in distress"  
RAPTUROUSLY|in an ecstatic manner; "he reacted ecstatically to my plan to travel to Africa"  
ADJECTIVALLY|as an adjective; in an adjectival manner  
JEERINGLY|in a disrespectful jeering manner  
TOPOLOGICALLY|from the point of view of topology  
JUSTIFIEDLY|with honesty; "he was rightly considered the greatest singer of his time"  
CURRISHLY|in a currish manner; meanspiritedly; "he behaved ignobly"  
DEPRECATIVELY|in a deprecative manner  
SCRUMPTIOUSLY|so as to produce a delightful taste; "I bought some more of these deliciously sweet peaches"  
DESOLATELY|in grief-stricken loneliness; without comforting circumstances or prospects  
FINE|an expression of agreement normally occurring at the beginning of a sentence  
CONFUSINGLY|in a bewildering and confusing manner; "her situation was bewilderingly unclear"  
FADDISHLY|in a faddish manner  
FREQUENTLY|many times at short intervals; "we often met over a cup of coffee"  
PROVOKINGLY|in a provocative manner; "`Try it,' he said provocatively"  
PETTISHLY|in a petulant manner; "he said testily; `Go away!'"  
ATOP|on, to, or at the top  
WINDILY|in a verbose manner; "she explained her ideas verbosely"  
WINSOMELY|in an engaging manner; "she played the role engagingly"  
ABREAST|alongside each other, facing in the same direction  
ARTICULATELY|with eloquence; "he expressed his ideas eloquently"  
SPORTINGLY|so as to be sporting; in a sporting manner  
GRUNGILY|in a dingy manner  
STORMILY|in a stormy or violent manner  
ALLOWABLY|in a permissible manner  
CURSEDLY|in a damnable manner; "kindly Arthur--so damnably , politely , endlessly persistent!"  
E'ER|at all times; all the time and on every occasion; "I will always be there to help you"; "always arrives on time"; "there is always some pollution in the air"; "ever hoping to strike it rich"; "ever busy"  
TRIPPINGLY|moving with quick light steps; "she walked lightsomely down the long staircase"  
VALOROUSLY|with valor; in a valiant manner; "he fought valiantly until the end"  
DIVERTINGLY|in an entertaining and amusing manner; "Hollywood has grown too sophisticated to turn out anything really amusingly bad these days"  
PRINCIPALLY|for the most part; "he is mainly interested in butterflies"  
DIGITATELY|in a digitate manner  
CLAMMILY|in a clammy manner  
DAUNTLESSLY|without fear; "fearlessly, he led the troops into combat"  
CURSIVELY|in a cursive manner  
ADAXIALLY|in an adaxial manner  
SMUTTILY|in a smutty manner  
SURPRISEDLY|in the manner of one who is surprised  
QUICKEST|most quickly  
DRASTICALLY|in a drastic manner  
UNREMARKABLY|under normal conditions; "usually she was late"  
COMPREHENSIVELY|in an all-inclusive manner  
FLASHILY|in a meretricious manner; "the boat is meretriciously decorated"  
POPISHLY|like the Pope; in a popish manner  
NONCOMPREHENSIVELY|in a limited way  
MEAGRELY|to a meager degree or in a meager manner; "these voices are meagerly represented at the conference"; "the area is slenderly endowed with natural resources"  
UNCO|to a remarkable degree or extent; "she was unusually tall"  
CREAKINGLY|in a creaky manner; "the old boat was moving along creakily"  
TIMELY|at an opportune time; "your letter arrived apropos"  
MOSTLY|in large part; mainly or chiefly; "These accounts are largely inactive"  
REGRETTABLY|by bad luck; "unfortunately it rained all day"; "alas, I cannot stay"  
RAVENOUSLY|in the manner of someone who is very hungry; "he pounced on the food hungrily"  
MOTHERLY|in a maternal manner; as a mother; "she loved her students almost maternally"  
COORDINATELY|in a coordinated manner  
BELOW|in or to a place that is lower  
FRUITLESSLY|in an unproductive manner  
UNREADABLY|in an illegible manner; "this student writes illegibly"  
SLOPINGLY|with a slant  
CONSTRAINEDLY|in a constrained manner  
HOSTILELY|with hostility; in a belligerent hostile manner; "he pushed her against the wall belligerently"  
PIANISSIMO|a direction in music; to be played very softly  
UNMINDFULLY|in a careless and thoughtless manner  
RECIPROCALLY|(often followed by `for') in exchange or in reciprocation; "gave up our seats on the plane and in return received several hundred dollars and seats on the next plane out"; "we get many benefits in return for our taxes"  
PUGNACIOUSLY|in a pugnacious manner  
AUTOCRATICALLY|in an overbearingly domineering manner; as a dictator; "this manager acts dictatorially toward his colleagues"  
SLICKLY|with superficial plausibility; "he talked glibly"  
STEREOTYPICALLY|in a stereotypical manner  
CHEERILY|in a cheerful manner; "`I'll do the dishes,' he said pleasantly"  
UNGRACEFULLY|without grace; rigidly; "they moved woodenly"  
ADVISEDLY|with intention; in an intentional manner; "he used that word intentionally"; "I did this by choice"  
PACIFICALLY|in a peaceable manner; "the tenant paying the rent hereby reserved and performing the several covenants herein on his part contained shall peaceably hold and enjoy the demised premises"  
SMACK|directly; "he ran bang into the pole"; "ran slap into her"  
FATUOUSLY|vacuously or complacently and unconsciously foolish  
CONVERSATIONALLY|with the use of colloquial expressions; "this building is colloquially referred to as The Barn"  
IRRESISTIBLY|incapable of being resisted; "the candy looked overwhelmingly desirable to the dieting man"  
MENIALLY|in a menial manner  
VULNERABLY|in a vulnerable manner  
PLEADINGLY|in a beseeching manner; "`You must help me,' she said imploringly"  
UNKNOWINGLY|without knowledge or intention; "he unwittingly deleted the references"  
CLOSEST|(superlative of `near' or `close') within the shortest distance; "that was the time he came nearest to death"  
WASTEFULLY|to a wasteful manner or to a wasteful degree; "we are still prodigally rich compared to others"  
OBSTINATELY|in a stubborn unregenerate manner; "she remained stubbornly in the same position"  
DEPENDABLY|in a faithful manner; "it always came on, faithfully, like the radio"  
RELEVANTLY|with relevance  
ARGUMENTATIVELY|in a disputatious manner  
ANTERIORLY|in an anterior direction  
MEANSPIRITEDLY|in a meanspirited manner  
COLDLY|in a cold unemotional manner; "he killed her in cold blood"  
ABLY|with competence; in a competent capable manner; "they worked competently"  
GAYLY|in a joyous manner; "they shouted happily"  
GRANDILOQUENTLY|in a rhetorically grandiloquent manner; "the orator spoke magniloquently"  
INSTANTANEOUSLY|without any delay; "he was killed outright"  
RUDELY|in an impolite manner; "he treated her impolitely"  
POLYGONALLY|in a polygonal manner  
DREAMFULLY|in a dreamy manner; "`She would look beautiful in the new dress,' Tommy said dreamily"  
HATEFULLY|in a hateful manner  
WORDLESSLY|without speaking; "he sat mutely next to her"  
UNARGUABLY|in an unarguable and undisputed manner; "you write as if this fact whilst inarguably forever condemning me to the ranks of Bohemianism nevertheless earned for me the right of entry into any company"  
INSTRUCTIVELY|in an informative manner  
PLEASURABLY|in a very pleasurable manner; "they were walking along the beach slowly and deliciously"  
MANLY|in a manful manner; with qualities thought to befit a man; "having said her say Peggy manfully shouldered her burden and prepared to break up yet another home"  
READABLY|in a legible manner; "you must write legibly"  
ANARCHICALLY|in a lawless rebellious manner  
UNACHIEVABLY|in an unattainable manner or to an unattainable degree; "this house is unattainably expensive"  
DISREGARDING|in spite of everything; without regard to drawbacks; "he carried on regardless of the difficulties"  
SHAMEFULLY|in a dishonorable manner or to a dishonorable degree; "his grades were disgracefully low"  
MAYHAP|by chance; "perhaps she will call tomorrow"; "we may possibly run into them at the concert"; "it may peradventure be thought that there never was such a time"  
OPERATIVELY|in a manner to produce an effect  
FRATERNALLY|in a brotherly manner  
INSISTENTLY|in an insistent manner  
LIEF|in a willing manner; "this was gladly agreed to"; "I would fain do it"  
SCARILY|in an alarming manner; "the disturbing thing about the Minister's behavior is that far from being artificial, it too often rings frighteningly true"  
DECIPHERABLY|in a legible manner; "you must write legibly"  
PATRONIZINGLY|with condescension; in a patronizing manner; "he treats his secretary condescendingly"  
SOUTHWARD|toward the south; "the ship turned southerly"  
RECKLESSLY|in a reckless manner  
INSUBSTANTIALLY|not substantially; lacking substantial expression or fullness  
VIRTUOUSLY|in a moral manner; "he acted morally under the circumstances"  
CHARMINGLY|in a charming manner  
DISBELIEVINGLY|in an incredulous manner; "the woman looked up at her incredulously"  
INTRINSICALLY|with respect to its inherent nature; "this statement is interesting per se"  
CHEEKILY|in a brash cheeky manner; "brashly, she asked for a rebate"  
CALUMNIOUSLY|in a false and slanderous and defamatory manner; with slander or calumny  
QUICKER|more quickly  
CORRUPTEDLY|in a corrupt manner  
ENDLESSLY|continuing forever without end; "there are infinitely many possibilities"  
SACRILEGIOUSLY|in a sacrilegious manner  
IMPERATIVELY|in an imperative and commanding manner  
CONJOINTLY|in conjunction with; combined; "our salaries put together couldn't pay for the damage"; "we couldn't pay for the damages with all our salaries put together"  
CONFOUNDEDLY|in a perplexed manner; "he looked at his professor perplexedly"  
UNPREDICTABLY|in an erratic unpredictable manner; "economic changes are proceeding erratically"  
PATRONISINGLY|with condescension; in a patronizing manner; "he treats his secretary condescendingly"  
FLEETLY|in a swift manner; "she moved swiftly"  
VIZ.|as follows  
CULPABLY|in a manner or to a degree deserving blame or censure  
APPREHENSIVELY|with anxiety or apprehension; "we watched anxiously"  
STUNNINGLY|in a spectacular manner; "the area was spectacularly scenic"  
OUTDOORS|outside a building; "in summer we play outside"  
YEARLY|without missing a year; "they travel to China annually"  
ENJOYABLY|in an enjoyable manner; "we spent a pleasantly lazy afternoon"  
OSMOTICALLY|by means of osmosis  
PRIMLY|in a prissy manner; "the new teacher alienates the children by behaving prissily"  
VEXATIOUSLY|in a vexatious manner  
SERIATIM|in a series; one after another  
BRUTISHLY|in an inhumane manner; "she treated her husband bestially"  
SCURVILY|in a despicable, ignoble manner; "this new leader meanly threatens the deepest values of our society"  
DEFENCELESS|without defense; "the child was standing in the middle of the crossfire, defenselessly"  
MUNDANELY|in a worldly manner; "terrestrially changeable"  
PERPENDICULARLY|straight up or down without a break  
SLANTWAYS|at a slant; moving or directed in a slantwise position or direction  
DEAD|quickly and without warning; "he stopped suddenly"  
STEADFASTLY|with resolute determination; "we firmly believed it"; "you must stand firm"  
MAYBE|by chance; "perhaps she will call tomorrow"; "we may possibly run into them at the concert"; "it may peradventure be thought that there never was such a time"  
PENITENTIALLY|showing remorse  
CIRCUMSPECTLY|in a cagey manner; "`I don't know yet,' he answered cagily"  
SYMBIOTICALLY|in a symbiotic manner  
SUBSERVIENTLY|in an obsequious manner; "she acts obsequiously toward her boss"  
SULLENLY|in a sullen manner; "he sat in his chair dourly"  
VOLITIONALLY|in a willing manner; "I willingly accept"  
HAPTICALLY|by touch; "he perceives shapes tactually"  
DENSELY|in a stupid manner; "he had so rapaciously desired and so obtusely expected to find her alone"  
INDOORS|within a building; "in winter we play inside"  
UNUTTERABLY|to an inexpressible degree; "she was looking very young tonight, and, as usual, indescribably beautiful, in a simple strapless dress of a green and white silky cotton"  
MELLOWLY|(obsolete) in a mellow manner  
BRUTALLY|in a vicious manner; "he was viciously attacked"  
HORTICULTURALLY|by means of horticulture  
LIMNOLOGICALLY|with regard to or concerning limnology  
COMMENSALLY|in a commensal manner  
HUMOURLESSLY|in a humorless manner; "he reacted rather humorlessly to these rumors"  
THIEVISHLY|in a manner characteristic of a thief  
THIRDLY|in the third place; "third we must consider unemployment"  
UNQUIETLY|with agitation or turbulence  
INCOMPATIBLY|without compatibility  
INQUISITIVELY|with curiosity; "the baby looked around curiously"  
FICTITIOUSLY|in a false manner intended to mislead  
LARGE|at a distance, wide of something (as of a mark)  
SUCCESSIVELY|in proper order or sequence; "talked to each child in turn"; "the stable became in turn a chapel and then a movie theater"  
SOMNOLENTLY|in a drowsy manner; "`Time to get up,' she said drowsily"  
PENITENTLY|showing remorse  
BESEECHINGLY|in a beseeching manner; "`You must help me,' she said imploringly"  
REFRESHFULLY|in a manner that relieves fatigue and restores vitality; "the air was refreshingly cool"  
DRIPPILY|in a mawkish and emotional manner; "the violinist played that piece mawkishly"  
STINGILY|in a stingy manner; "their rich uncle treated them rather chintzily"  
UPRIGHTLY|in an honorable manner; "he acted honorably"  
OBTRUSIVELY|in an obtrusive manner  
VENOMOUSLY|in a very malevolent manner  
FRUMPILY|in a dowdy unfashionable manner; "she dresses dowdily"  
UNCTUOUSLY|in an unctuous manner  
'TWEEN|in between; "two houses with a tree between"  
UNUNDERSTANDABLY|in an unintelligible manner; "the foreigners spoke unintelligibly"  
UNDECIPHERABLY|in an illegible manner; "this student writes illegibly"  
SOU'WEST|to, toward, or in the southwest  
HEREWITH|(formal) by means of this; "I hereby declare you man and wife"  
ENCHANTINGLY|in a bewitching manner; "she was bewitchingly beautiful"  
HERETOFORE|used in negative statement to describe a situation that has existed up to this point or up to the present time; "So far he hasn't called"; "the sun isn't up yet"  
EXPEDITIOUSLY|with efficiency; in an efficient manner; "he functions efficiently"  
RESERVEDLY|with reserve; in a reserved manner  
SHREWISHLY|in a shrewish manner  
SHAMBOLICALLY|in a shambolic manner  
UNACCOMPANIED|without anybody else or anything else; "the child stayed home alone"; "the pillar stood alone, supporting nothing"; "he flew solo"  
PASSABLY|to a moderately sufficient extent or degree; "pretty big"; "pretty bad"; "jolly decent of him"; "the shoes are priced reasonably"; "he is fairly clever with computers"  
AMORALLY|without regard for morality; "he acted immorally when his own interests were at stake"  
SCIENTER|(law) deliberately or knowingly  
COOPERATIVELY|in close cooperation; "they work hand in glove"  
APIECE|to or from every one of two or more (considered individually); "they received $10 each"  
PERVASIVELY|in a pervasive manner  
SENTENTIOUSLY|in a pithy sententious manner; "she expressed herself pithily"  
IRREPARABLY|in an irreparable manner or to an irreparable degree  
PETULANTLY|in a petulant manner; "he said testily; `Go away!'"  
IMPOTENTLY|in a helpless manner; "the crowd watched him helplessly"  
DOWNTOWN|toward or in the lower or central part of town  
INSECTICIDALLY|by means of an insecticide  
REPUTABLY|in a reputable manner  
UNSHAKABLY|with determination; in a determined manner; "he clung to the past determinedly"  
UNREPRODUCIBLY|in an unreproducible manner; "he has an inimitably verbose style"  
SPOOKILY|in an unnatural eery manner; "it was eerily quiet in the chapel"  
EXCEEDINGLY|to an extreme degree; "extremely cold"; "extremely unpleasant"  
JUSTLY|with honesty; "he was rightly considered the greatest singer of his time"  
CAPTIVATINGLY|in a bewitching manner; "she was bewitchingly beautiful"  
SHALLOWLY|in a shallow manner  
OBSERVANTLY|in an observant manner  
EXCESSIVELY|to a degree exceeding normal or proper limits; "too big"  
FRONTWARDS|at or to or toward the front; "he faced forward"; "step forward"; "she practiced sewing backward as well as frontward on her new sewing machine"; (`forrad' and `forrard' are dialectal variations)  
DESIGNEDLY|with intention; in an intentional manner; "he used that word intentionally"; "I did this by choice"  
RASPINGLY|in a harsh and grating manner; "her voice fell gratingly on our ears"  
SPEEDILY|with rapid movements; "he works quickly"  
OFTENER|more often or more frequently  
CAPRICIOUSLY|unpredictably; "the weather has been freakishly variable"  
MAGISTERIALLY|in an overbearingly domineering manner; as a dictator; "this manager acts dictatorially toward his colleagues"  
LAUDABLY|in an admirable manner; "the children's responses were admirably normal"  
CLAMOROUSLY|in manner that attracts attention; "obstreperously, he demanded to get service"  
TELEGRAPHICALLY|in a short and concise manner; "a particular bird, exactly and tersely described in the book of birds"  
YIELDINGLY|in an obedient manner; "obediently she slipped off her right shoe and stocking"  
WILFULLY|in a willful manner; "she had willfully deceived me"  
EXHAUSTIVELY|in an exhaustive manner; "we searched the files thoroughly"  
CAUDAL|toward the posterior end of the body  
PROGRESSIVELY|advancing in amount or intensity; "she became increasingly depressed"  
BLOODILY|involving a great bloodshed  
LASTINGLY|in an enduring or permanent manner  
FILTHILY|in a filthy unclean manner; "a dirtily dressed camel driver"  
PLAGUILY|in a disagreeable manner; "it's so plaguey cold!"  
A.D.|in the Christian era; used before dates after the supposed year Christ was born; "in AD 200"  
PRECIPITATELY|at breakneck speed; "burst headlong through the gate"  
CHIRPILY|in a cheerfully buoyant manner; "we accepted the opportunity buoyantly"  
TORPIDLY|in a daze; in a dazed manner; "he wondered dazedly whether the term after next at his new school wouldn't matter so much"  
HEREINBEFORE|in the preceding part of the current text  
PUBLICALLY|in a manner accessible to or observable by the public; openly; "she admitted publicly to being a communist"  
TRANSCENDENTALLY|in a transcendental way or to a transcendental extent  
MANDATORILY|in a manner that cannot be evaded; "the ministry considers that contributions to such a fund should be met from voluntary donations rather than from rates compulsorily levied."  
GARRULOUSLY|in a chatty loquacious manner; "`When I was young,' she continued loquaciously, `I used to do all sorts of naughty things'"  
BLESSEDLY|in a blessed manner  
VOLUBLY|in a chatty manner; "`when I was a girl,' she said chattily, `I used to ride a bicycle'"  
HONOURABLY|with honor; "he was honorably discharged after many years of service"  
DRILY|in a dry laconic manner; "I know that," he said dryly  
JESTINGLY|in jest; "I asked him jokingly whether he thought he could drive the Calcutta-Peshawar express"  
SPARINGLY|to a meager degree or in a meager manner; "these voices are meagerly represented at the conference"; "the area is slenderly endowed with natural resources"  
SEQUENTIALLY|in a consecutive manner; "we numbered the papers consecutively"  
MANIPULATIVELY|in an artfully manipulative manner  
INTOLERABLY|to an unacceptable degree; "The percentage of lead in our drinking water is unacceptably high"  
CONJECTURALLY|in a manner involving or inclined to conjecture and supposition  
PLENTEOUSLY|in a bountiful manner  
LUCKILY|by good fortune; "fortunately the weather was good"  
IMPALPABLY|not substantially; lacking substantial expression or fullness  
PERIPHERALLY|in or at or near a periphery or according to a peripheral role or function or relationship  
UNMERCIFULLY|without pity; in a merciless manner; "he was mercilessly trounced by his opponent in the House"  
NERVILY|in a brash cheeky manner; "brashly, she asked for a rebate"  
DISCURSIVELY|in a rambling manner  
FEASIBLY|in a practicable manner; so as to be feasible  
REMARKABLY|to a remarkable degree or extent; "she was unusually tall"  
GENEROUSLY|in a generous manner; "he gave liberally to several charities"  
UNWARILY|without heed or caution  
RESIDENTIALLY|used as a residence  
UNFAITHFULLY|in an unfaithful undependable unreliable manner  
NONETHELESS|despite anything to the contrary (usually following a concession); "although I'm a little afraid, however I'd like to try it"; "while we disliked each other, nevertheless we agreed"; "he was a stern yet fair master"; "granted that it is dangerous, all the same I still want to go"  
LICITLY|in a manner acceptable to common custom; "you cannot do this legitimately!"  
CHROMATOGRAPHICALLY|by means of a chromatographic process  
PERCEPTIVELY|in a perceptive manner  
DISHONOURABLY|in a dishonorable manner or to a dishonorable degree; "his grades were disgracefully low"  
FORTE|used as a direction in music; to be played relatively loudly  
HARMFULLY|in a detrimental manner  
GENIALLY|in an affable manner; "`Come and visit me,' he said amiably"  
UNWORTHILY|in an unworthy manner  
TREMENDOUSLY|extremely; "he was enormously popular"  
WONDERFULLY|(used as an intensifier) extremely well; "her voice is superbly disciplined"; "the colors changed wondrously slowly"  
UNSUITABLY|in an inappropriate manner; "he was inappropriately dressed"  
ENDEARINGLY|in an adorable manner; "the toddler behaved adorably"  
PALLIDLY|in a manner lacking interest or vitality; "a palely entertaining show"  
GIBINGLY|in a disrespectful jeering manner  
COUNTERINTUITIVELY|in a counterintuitive manner  
INCRIMINATINGLY|in an incriminating manner  
HYDRAULICLY|in a hydraulic manner; "the block is then tested hydraulically to its full design test pressure on each stream separately"  
THITHER|to or toward that place; away from the speaker; "go there around noon!"  
ASLANT|over or across in a slanting direction  
NONCHALANTLY|in a composed and unconcerned manner; "without more ado Barker borrowed a knife from his brigade Major and honed it on a carborundum stone as coolly as a butcher"  
HEEDLESSLY|without care or concern; "carelessly raised the children's hopes without thinking of their possible disappointment"  
INTRICATELY|with elaboration; "it was elaborately spelled out"  
CHEAPLY|in a stingy manner; "their rich uncle treated them rather chintzily"  
OBSESSIVELY|in a compulsive manner; "he cleaned his shoes compulsively after every walk"  
VULGARLY|in a smutty manner  
ULTERIORLY|in an ulterior manner  
BACKWARDS|at or to or toward the back or rear; "he moved back"; "tripped when he stepped backward"; "she looked rearward out the window of the car"  
INATTENTIVELY|in an absentminded or preoccupied manner; "he read the letter absently"  
SAVAGELY|in a vicious manner; "he was viciously attacked"  
INSENSIBLY|in a numb manner; without feeling; "I stared at him numbly"  
MIDWAY|at half the distance; at the middle; "he was halfway down the ladder when he fell"  
RIOTOUSLY|in a tumultuous and riotous manner; "the crowd was demonstrating tumultuously"  
INCESSANTLY|with unflagging resolve; "dance inspires him ceaselessly to strive higher and higher toward the shining pinnacle of perfection that is the goal of every artiste"  
PROFOUNDLY|to a great depth psychologically; "They felt the loss deeply"  
EXTRAVAGANTLY|in an abundant manner; "they were abundantly supplied with food"; "he thanked her profusely"  
ANTICLOCKWISE|in a direction opposite to the direction in which the hands of a clock move; "please move counterclockwise in a circle!"  
OPPOSITELY|in an opposite position  
LANGSYNE|at a distant time in the past (chiefly Scottish)  
SLOWER|more slowly  
PUSILLANIMOUSLY|with a lack of courage and determination; "simperingly, the accused begged for mercy"  
FREE|without restraint; "cows in India are running loose"  
UNMEMORABLY|in an unmemorable manner  
ASTRADDLE|with one leg on each side; "she sat astride the chair"  
INCORRECTLY|in an incorrect manner; "to credit Lister with the first formulation of the basic principle of stratigraphy would be to bestow credit falsely"  
SPIRITEDLY|in a spirited or lively manner; with animation and vivacity  
DEFENCELESSLY|without defense; "the child was standing in the middle of the crossfire, defenselessly"  
SOPPING|extremely wet; "dripping wet"; "soaking wet"  
PARASITICALLY|in a parasitic manner  
ANNOYINGLY|in an annoying manner or to an annoying degree  
PREEMINENTLY|to a preeminent degree; with superiority or distinction above others; in a preeminent manner; "a wide variety of pre-eminently contemporary scenes"  
SOMBRELY|in a somber manner; "`That's sure bad news,' said Dowd, somberly"  
STAIDLY|in a grave and sober manner; "he walked soberly toward the altar"  
PURPOSELY|with intention; in an intentional manner; "he used that word intentionally"; "I did this by choice"  
ADMITTEDLY|as acknowledged; "true, she is the smartest in her class"  
UNBELIEVINGLY|in an incredulous manner; "the woman looked up at her incredulously"  
BRUSQUELY|in a blunt direct manner; "he spoke bluntly"; "he stated his opinion flat-out"; "he was criticized roundly"  
WEARILY|in a weary manner; "he walked around tiredly"  
DOWNRIVER|away from the source or with the current  
CHIVALROUSLY|in a gallant manner; "he gallantly offered to take her home"  
IMMUTABLY|in an unalterable and unchangeable manner; "his views were unchangeably fixed"  
SCANTILY|in a sparse or scanty way; "a barely furnished room"  
DISREPUTABLY|in a disreputable manner  
DUBIOUSLY|in a questionable and dubious manner; "these were estates his father questionably acquired"  
PELLUCIDLY|in a clear and lucid manner; "this is a lucidly written book"  
PENALLY|in a punishing manner  
BETWIXT|in the interval; "dancing all the dances with little rest between"  
SAGACIOUSLY|in a shrewd manner; "he invested his fortune astutely"; "he was acutely insightful"  
GUARDEDLY|in a conservative manner; "we estimated the number of demonstrators conservatively at 200,000."  
OBSERVABLY|in a noticeable manner; "he changed noticeably over the years"  
MARVELLOUSLY|(used as an intensifier) extremely well; "her voice is superbly disciplined"; "the colors changed wondrously slowly"  
FAITHLESSLY|in a disloyal and faithless manner; "he behaved treacherously"; "his wife played him false"  
IMMINENTLY|in an imminent manner  
UPTOWN|toward or in the upper part of town  
COINCIDENTLY|happening at the same time  
I.E.|that is to say; in other words  
ODDLY|in a manner differing from the usual or expected; "had a curiously husky voice"; "he's behaving rather peculiarly"  
THEORETICALLY|in theory; according to the assumed facts; "on paper the candidate seems promising"  
ARIGHT|in an accurate manner; "the flower had been correctly depicted by his son"; "he guessed right"  
BOISTEROUSLY|in a carefree manner; "she was rollickingly happy"  
PROFITABLY|in a productive way; "they worked together productively for two years"  
VENTRALLY|in a ventral location or direction  
CUTTINGLY|in an intentionally unkind way; "a cutting remark"  
REPRODUCIBLY|in a manner that is reproducible  
WRONGHEADEDLY|in a wrongheaded manner  
SERVILELY|in an obsequious manner; "she acts obsequiously toward her boss"  
BOASTFULLY|in a boastful manner; "he talked big all evening"  
NORMALLY|under normal conditions; "usually she was late"  
EXULTANTLY|in an exultant manner; "it was exultingly easy"  
NAMELY|as follows  
INEXPENSIVELY|in a cheap manner; "a cheaply dressed woman approached him in the bar"  
ARBITRARILY|in a random manner; "the houses were randomly scattered"; "bullets were fired into the crowd at random"  
FIRSTLY|before anything else; "first we must consider the garter snake"  
IRRITATINGLY|in an irritating manner  
B.C.|before the Christian era; used following dates before the supposed year Christ was born; "in 200 BC"  
SUPPOSEDLY|believed or reputed to be the case  
LASTLY|the item at the end; "last, I'll discuss family values"  
UNRECOGNISABLE|beyond recognition; in an unrecognizable manner; "he had unrecognizably aged"  
SINUOUSLY|in a sinuous manner  
WONDERINGLY|in a curious and questioning manner; "they turned their heads questioningly, as if awaiting further instructions"  
WITHIN|on the inside; "inside, the car is a mess"  
DOWNWARDLY|spatially or metaphorically from a higher to a lower level or position; "don't fall down"; "rode the lift up and skied down"; "prices plunged downward"  
PUNCTUALLY|at the proper time; "she was duly apprised of the raise"  
REPREHENSIVELY|in a shameful manner; "the garden was criminally neglected"  
FACIALLY|with respect to the face  
ENDWISE|on end or upright; "sticks leaning against the wall endways"  
GROSSLY|in a gross manner  
HORRIDLY|in a hideous manner; "her face was hideously disfigured after the accident"  
PUCKISHLY|in an appealing but bold manner; "she asked him impishly to come in"  
BOUNTEOUSLY|in a bountiful manner  
JAGGEDLY|with a ragged and uneven appearance; "a long beard, raggedly cut"  
DEPLORABLY|in an unfortunate or deplorable manner; "he was sadly neglected"; "it was woefully inadequate"  
IGNOMINIOUSLY|in a dishonorable manner or to a dishonorable degree; "his grades were disgracefully low"  
COUNTERACTIVELY|in a counteractive manner  
FRUMPISHLY|in a dowdy unfashionable manner; "she dresses dowdily"  
NOXIOUSLY|in a detrimental manner  
ETERNALLY|for a limitless time; "no one can live forever"; "brightly beams our Father's mercy from his lighthouse evermore"- P.P.Bliss  
CONTRITELY|in a rueful manner; "`I made a big mistake,' he said ruefully"  
INVARIABLY|without variation or change, in every case; "constantly kind and gracious"; "he always arrives on time"  
HYPOTHETICALLY|by hypothesis  
FASTIDIOUSLY|in a fastidious and painstaking manner; "it is almost a waste of time painstakingly to learn the routines of selling"  
INWARDS|to or toward the inside of; "come in"; "smash in the door"  
CLIQUISHLY|in a clannish manner; "these four friends always act clannishly, and don't let us participate in their activities"  
ABED|in bed  
EMPHATICALLY|without question and beyond doubt; "it was decidedly too expensive"; "she told him off in spades"; "by all odds they should win"  
CREDITABLY|to a tolerably worthy extent; "he did respectably well for his age"  
INJURIOUSLY|in an injurious manner  
APACE|with rapid movements; "he works quickly"  
OBSERVINGLY|in an observant manner  
FISHILY|in a questionably unusual manner; "this money had been queerly come by"  
UNEVENLY|in an uneven and irregular way  
TATTILY|in a cheap manner; "a cheaply dressed woman approached him in the bar"  
BLITHELY|in a joyous manner; "they shouted happily"  
ORIGINALLY|in an original manner  
DISCONSOLATELY|in grief-stricken loneliness; without comforting circumstances or prospects  
SLACKLY|in a relaxed manner; not rigid; "his hands lay loosely"  
IRREGARDLESS|regardless; a combination of irrespective and regardless sometimes used humorously  
ENERGETICALLY|in an energetic manner  
BENEATH|in or to a place that is lower  
INGENUOUSLY|in an ingenuous manner; "she answered the judge's questions artlessly"  
DELICATELY|in a delicate manner; "finely shaped features"; "her fine drawn body"  
CANNILY|with foresight; "more presciently than they superiors, these workers grasped the economic situation"  
EQUIVOCALLY|in an ambiguous manner; "this letter is worded ambiguously"  
OBLIQUELY|to, toward or at one side; "darting eyes looking sidelong out of a wizened face"  
SCRUPULOUSLY|with extreme conscientiousness; "he came religiously every morning at 8 o'clock"  
FALTERINGLY|in an unsteady manner; "he walked unsteadily toward the exit"; "The wounded soldier was swinging unsteadily on his legs"  
TRUSTFULLY|with trust; in a trusting manner; "she looked at her father trustingly"  
UNDISPUTEDLY|in an unarguable and undisputed manner; "you write as if this fact whilst inarguably forever condemning me to the ranks of Bohemianism nevertheless earned for me the right of entry into any company"  
OPTIMALLY|in an optimal and most desirable way  
RHAPSODICALLY|in an ecstatic manner; "he reacted ecstatically to my plan to travel to Africa"  
CONTRARIWISE|in a contrary disobedient manner  
IDYLLICALLY|in an idyllic manner  
ARTLESSLY|in a crude and unskilled manner; "an inexpertly constructed lean-to"  
BROADWISE|in the direction of the breadth; "cut the cloth breadthwise"  
UPRIVER|toward the source or against the current  
IMPROBABLY|not easy to believe; "behind you the coastal hills plunge to the incredibly blue sea backed by the Turkish mountains"  
UNMANLY|without qualities thought to befit a man  
TIMOROUSLY|in a timorous and trepid manner  
SHREWDLY|in a shrewd manner; "he invested his fortune astutely"; "he was acutely insightful"  
INITIALLY|at the beginning; "at first he didn't notice anything strange"  
FUNNILY|in a strange manner; "a queerly inscribed sheet of paper"  
FADDILY|in a faddish manner  
SLANDEROUSLY|in a false and slanderous and defamatory manner; with slander or calumny  
MERRILY|in a joyous manner; "they shouted happily"  
YEARNINGLY|in a yearning manner; "he spent the rest of the act gazing longingly over my right shoulder at the illuminated word `Exit'"  
EXTEMPORE|without prior preparation; "he spoke extemporaneously"  
DINGILY|in a dingy manner  
UNTIDILY|in a messy, untidy manner; "Rossi spat very deliberately, and very messily, upon Durieux's party card"  
INDECOROUSLY|without decorousness  
COTERMINOUSLY|in a coterminous manner  
FIENDISHLY|as a devil; in an evil manner; "his writing could be diabolically satiric"  
PASSIM|used to refer to cited works  
PITEOUSLY|in a piteous manner  
COPIOUSLY|in an abundant manner; "they were abundantly supplied with food"; "he thanked her profusely"  
PERFORCE|by necessity; by force of circumstance  
A.K.A.|as known or named at another time or place; "Mr. Smith, alias Mr. Lafayette"  
INSCRIPTIVELY|by means of an inscription  
UNCONTROVERSIALLY|not involving any controversy  
IRREVOCABLY|in an irrevocable manner  
INADVISABLY|in an expedient manner  
PROPITIOUSLY|in an auspicious manner; "he started his new job auspiciously on his birthday"  
PRECEDENTEDLY|with precedent  
TACITURNLY|without speaking; "he sat mutely next to her"  
TEPIDLY|in an unenthusiastically lukewarm manner; "he was lukewarmly received by his relatives"  
FECKLESSLY|with ineptitude; in an incompetent manner; "he performed his functions ineptly"  
SECONDLY|in the second place; "second, we must consider the economy"  
SORDIDLY|in a sordid or squalid way  
WATCHFULLY|in a watchful manner  
INELOQUENTLY|without eloquence; in an inarticulate manner; "the freshman expresses his thoughts inarticulately"  
LAWLESSLY|in an illegal manner; "they dumped the waste illegally"  
SEMIANNUALLY|twice a year  
SPRUCELY|in a stylish manner; "He was smartly dressed"  
GRANDIOSELY|in a grandiose manner; "the building was bombastically spacious"  
IRRESPECTIVE|in spite of everything; without regard to drawbacks; "he carried on regardless of the difficulties"  
FRACTIOUSLY|in a peevish manner  
FINALLY|after an unspecified period of time or an especially long delay  
PREPOSTEROUSLY|so as to arouse or deserve laughter; "her income was laughably small, but she managed to live well"  
UNENERGETICALLY|without energy; in a lethargic manner; "he hung around the house lethargically"  
WEALTHILY|with riches  
DEXTEROUSLY|with dexterity; in a dexterous manner; "dextrously he untied the knots"  
PERMISSIVELY|in a permissive manner  
JOYOUSLY|in a joyous and gleeful manner; "the old man had greeted her gleefully"  
STODGILY|in a stuffy manner; "`Come in please,' he said stuffily"  
COMPASSIONATELY|in a compassionate manner; "the nurse looked at him pityingly"  
IRRESOLUTELY|lacking determination or decisiveness  
HANDILY|in a convenient manner; "the switch was conveniently located"  
RUGGEDLY|in a rugged manner  
EXCELLENTLY|extremely well; "he did splendidly in the exam"; "we got along famously"  
WESTWARDS|toward the west; "they traveled westward toward the setting sun"  
FORTUITOUSLY|by good fortune; "fortunately the weather was good"  
WHEREVER|where in the world  
PURPORTEDLY|believed or reputed to be the case  
IRRITABLY|in a petulant manner; "he said testily; `Go away!'"  
TENTHLY|(in enumerating something, such as topics or points of discussion) in the tenth place  
LEWDLY|in a lewd and obscene manner; "he had seen how in their dances the white men and women held one another obscenely"  
HESITATINGLY|with hesitation; in a hesitant manner; "he finally accepted hesitantly"  
PENETRATIVELY|with ability to see into deeply; "the author treats his subject penetratingly"  
METONYMICALLY|in a metonymic manner  
NOISELESSLY|without a sound; "he stood up soundlessly and speechlessly and glided across the hallway and through a door"  
REVERSELY|in an opposite way; so as to be reversed  
LIVIDLY|in a livid manner  
THROUGHOUT|from first to last; "the play was excellent end-to-end"  
INTOLERANTLY|in an intolerant manner  
TIRESOMELY|in a tedious manner; "boringly slow work"; "he plodded tediously forward"  
SQUALIDLY|in a sordid or squalid way  
OFTTIMES|many times at short intervals; "we often met over a cup of coffee"  
BONNILY|in a bonny manner  
TAUNTINGLY|in a playfully teasing manner; "`You hate things to be out of order, don't you?' she said teasingly"  
SLOWEST|most slowly  
BOUNTIFULLY|in a bountiful manner  
BIYEARLY|every two years; "this festival takes places biennially"  
INEFFABLY|to an inexpressible degree; "she was looking very young tonight, and, as usual, indescribably beautiful, in a simple strapless dress of a green and white silky cotton"  
INTREPIDLY|without fear; "fearlessly, he led the troops into combat"  
REBUKINGLY|in the manner of someone delivering a rebuke  
COVETOUSLY|with jealousy; in an envious manner; "he looked at his friend's new car jealously"  
UNPROFITABLY|without gain or profit  
LEARNEDLY|with erudition; in an erudite manner; "he talked eruditely about Indian mythology"  
INEXPEDIENTLY|in an inexpedient manner  
AFTERWARDS|happening at a time subsequent to a reference time; "he apologized subsequently"; "he's going to the store but he'll be back here later"; "it didn't happen until afterward"; "two hours after that"  
MOCKINGLY|in a disrespectful jeering manner  
VISCIDLY|in a sticky viscid manner; "he felt the blood move stickily from his split scalp and trickle down his forehead"  
FORWARDS|at or to or toward the front; "he faced forward"; "step forward"; "she practiced sewing backward as well as frontward on her new sewing machine"; (`forrad' and `forrard' are dialectal variations)  
SKILFULLY|with skill; "fragments of a nearly complete jug, skillfully restored at the institute of archaeology"  
SMARMILY|in an unctuous manner  
SHORT|quickly and without warning; "he stopped suddenly"  
MALIGNANTLY|in a malignant manner, as of a tumor that spreads  
HYPERBOLICALLY|in an exaggerated manner  
PROTRACTEDLY|in a slow, leisurely or prolonged way; "her voice was swift, yet ever the last words fell lingeringly" -Rossetti  
WORDILY|in a verbose manner; "she explained her ideas verbosely"  
BOUNDLESSLY|without bounds; "he is infinitely wealthy"  
HEAVENWARDLY|toward heaven; "he pointed heavenward"  
FRENETICALLY|in a very agitated manner; as if possessed by an evil spirit  
SUPERCILIOUSLY|with a sneer; in an uncomplimentary sneering manner; "`I don't believe in these customs,' he said sneeringly"  
ABSTRACTLY|in abstract terms  
REWARDINGLY|in a rewarding manner  
OVERBEARINGLY|in an overbearing manner  
PEEVISHLY|in a peevish manner  
NORTHWESTWARDLY|in a northwestward direction  
UNASSAILABLY|in an unalterable and unchangeable manner; "his views were unchangeably fixed"  
ASTONISHINGLY|in an amazing manner; to everyone's surprise; "amazingly, he finished medical school in three years"  
OVERPOWERINGLY|incapable of being resisted; "the candy looked overwhelmingly desirable to the dieting man"  
PRONTO|in a punctual manner; "he did his homework promptly"  
INTEGRALLY|in an integral manner  
UNAPPRECIATIVELY|in an ungrateful manner  
GAINLESSLY|without gain or profit  
ONWARDS|in a forward direction; "go ahead"; "the train moved ahead slowly"; "the boat lurched ahead"; "moved onward into the forest"; "they went slowly forward in the mud"  
UNITEDLY|with cooperation and interchange; "we worked together on the project"  
SOUTHEASTWARDLY|in a southeastward direction; "the river flows southeastward to the gulf"  
REVENGEFULLY|in a vindictive, revengeful manner; "he plotted vindictively against his former superiors"  
UNTYPICALLY|in a manner that is not typical; "she was atypically quiet"  
MIDDLING|to a moderately sufficient extent or degree; "pretty big"; "pretty bad"; "jolly decent of him"; "the shoes are priced reasonably"; "he is fairly clever with computers"  
TORTUROUSLY|in a very painful manner; "the progress was agonizingly slow"  
PROPORTIONALLY|to a proportionate degree; "your salary will rise proportionately to your workload"  
INEXHAUSTIBLY|with indefatigable energy; "she watched the show indefatigably"  
SOCIABLY|in a gregarious manner  
SUPERLATIVELY|to a superlative degree  
UNORIGINALLY|in an unoriginal manner  
COASTWARD|in the direction of the coast  
UNREASONINGLY|in an unreasoning visceral manner  
IMPENITENTLY|in an impenitent manner; "he repeated his position unrepentantly"  
DAFTLY|in a mildly insane manner; "the old lady is beginning to behave quite dottily"  
ENQUIRINGLY|in an inquiring manner; "Tom Swift looked at his cabin mates inquiringly"  
IMPERTINENTLY|in an impudent or impertinent manner; "a lean, swarthy fellow was peering through the window, grinning impudently"  
PIZZICATO|with a light plucking staccato sound  
ISOTROPICALLY|in an isotropic manner  
